0,3,1,6,1,3,0
0,4,4,4,4,4,0
0,4,5,4,4,4,0
0,4,4,4,0,4,0
0,4,4,4,2,4,0
0,4,4,4,4,4,0
1,1,1,4,1,1,1