-1,0,6,0,-1
-1,0,4,0,-1
0,3,4,3,0
0,4,4,4,0
0,4,2,4,0
0,4,4,4,0
1,0,4,0,1
-1,0,4,0,-1
0,3,4,3,0
0,4,4,4,0
1,0,4,0,1
-1,0,4,0,-1
0,3,4,3,0
0,4,4,4,0
1,0,4,0,1
-1,0,4,0,-1
0,3,4,3,0
0,4,4,4,0
0,4,4,4,0
1,1,1,1,1
