0,0,0,0,0,0,0,0,0,0
0,1,1,1,1,1,1,1,1,0
0,10,10,10,10,10,10,10,10,0
0,10,10,10,10,10,10,18,10,0
0,10,10,10,10,10,10,10,10,0
0,10,10,18,10,10,10,10,10,0
0,10,10,10,10,10,10,10,10,0
0,10,10,10,10,10,10,18,10,0
0,10,10,10,10,10,10,10,10,0
0,0,0,0,0,0,0,0,0,0