0,3,2,3,6,1,3,2,3,0
0,4,4,4,4,4,4,4,4,0
0,4,4,4,4,4,4,4,4,0
0,4,4,4,4,4,5,4,4,0
0,4,4,4,0,0,4,4,4,0
0,4,4,5,3,3,4,4,4,0
0,4,4,4,4,4,4,5,4,0
0,4,5,4,4,4,4,4,4,0
0,4,4,4,4,4,4,4,4,0
1,1,1,1,1,1,1,1,1,1
